++++++++++++++++++++++
+   +   ++ ++     +  +
+ +   +       +++ + ++
+ + +  ++  ++++   + ++
+++ ++++++    +++ +  +
+          ++  ++    +
+++++ ++++++++++++++ +
+     +   +    S+  + +
+ +++++++        +   +
+                + +++
++++++++++++++++++ +++